
NO   textures/north.xpm
   WE textures/west.xpm


        SO textures/south.xpm
 EA textures/east.xpm

            C             10,10,10
F 255,255,255

111111111111111111111111
100000000000000000000001
100000000000000000000001
100000000000000000000001
100000111110000101010001
100000100010000000000001
100000100010000100010001
100000100010000000000001
100000110110000101010001
100000000000000000000001
100000100000000000000001
100000000000000010000001
100000000000000000000001
100000000000000000000001
100000000000000000000001
100000000001000000000001
111111111000000000000001
110100001000000000E00001
110000101000000000000001
110100001000011111111111
110111111000000000000001
110000000000000000000001
111111111000010000001001
111111111111111111111111
