
NO   textures/north1.xpm
   WE textures/west1.xpm         

C 220,120,90
        SO textures/south1.xpm
 EA textures/east1.xpm


	  F 		255,,255,255

111111111111111111111111
100000000000000000000001
100000000000000000000001
100000000000000000000001
100000111110000101010001
100000100010000000000001
100000100010000100010001
100000100010000000000001
100000110110000101010001
100000000000000000000001
100000000000000000000001
100000000000000000000001
100000000000000000000001
100000000000000000000001
100000000000000000000001
100000000000000000000001
111111111000000001010001
110100001000000000N00001
110000101000000000000001
110100001000011111011111
110111111000000000000001
110000000000000000000001
111111111000000000000001
111111111111111111111111