NO ./path_to_the_north_texture
SO ./path_to_the_south_texture
WE ./path_to_the_west_texture
EA ./path_to_the_east_texture

F 220,100,0
C 225,30,0

11111111111111111111111111 
11000000000000011111111111
10000000000110000100000001
10110000011100000000000011
1111111111000000000000011111111111
100000010000000000110000100000001
10000001011000N011100000000000011
10000001001000000000000000E000001
111111111011000001110000000000001
1000000000110000011101111111111111
1111011111111101110000001000100001
1111011111111101110101001000111111
11000000110101011100000010001
10000000000000001100000010001
10000000000000001101010010001
1100000111010101111101111000111
11110111 1110101 101111010001
11111111 1111111 111111111111