

NO	./textures/north.xpm
SO	./textures/south.xpm
WE	./textures/west.xpm
EA	./textures/east.xpm


F	68,68,68
C	51,204,255

11111111111111111   11111
10000000000000011   10001
10000000000000001   10001
1000000000000000111110001
1000000000000000000000001
1000000000000000000000001
1000000000000000000000001
1000000000000000000000001
1000000000000000000000001
1000000000000000000000001
1000000000000000000000001
1000000000000000000000001
1000000000000000000000001
1000000000000000000000001
1000000000000000000000001
1000000000000000W00000001
1000000000000000000000001
1000000000000000000000001
1000000000000000000000001
11111000000000000000000011111
    1000000000000000000000001
11111000000000000000000011111
1000000000000000000000001
1000000000000000010000001
1111111111111111111111111