NO   textures/north.xpm
   WE textures/west.xpm


        SO textures/south.xpm
 EA textures/east.xpm

            C             10,10,10
F 255,255,255

11111111111111111111111111111111
1000000001   110000001
1000000001    10000001
1000000001    10000001   
100N000001    10000001
1000000001   110000001
1111111111111111111111
1111111111111111111111