
NO ./textures/north.xpm
SO ./textures/south.xpm
WE ./textures/west.xpm
EA ./textures/east.xpm

F 22,89,6
C 153,204,255

        111111111111111111111111111111111111111111111111
        100000000011000000000000000000000000000000000001 
        101100000111000000000000000000000000000000000001
        100100000000000000000000000000000000000000000001
11111111101100000111000000000000000000000000000000000001  
10000000001100000111011111111111111111111111111111111111
11110111111111111101110000001
11110111111111011101010010101
11000000110101011100000010001
101010000000W0000000000010001
10000000000000001101010010001
1100000111010101111101111000111
11110111 1110101 101111010001
11111111 1111111 111111111111
