NO textures/north.xpm

SO textures/north.xpm

WE textures/north.xpm
EA textures/north.xpm




 

EA textures/north.xpm

 




F 255,255

	 C 100,100,100


  11111111111
1111000000001
1000N00001111
1111111111